***************************************
*.*.***.***..............****.........*
*.*.*...*...****.*.*******....*.*****.*
*.*....****...*..*.*.....*..***.*.....*
*.*.*****.*.****.*.*.******.*...*..*..*
*.*...**....*....*.*........*..**.***.*
*.***..*.*.*******.***.**.*.**..*...*.*
*.*....*.*.*....*...**.*..*..**.***.*.*
*.*.****.*...*..*.*....*.***.*...*..*.*
*...*....******.*.****.*..*..******.*.*
*.*****.*...*.*.*....*...****...***.*.*
*.*.*...*.*.*.....*..*.*..*.***.....*.*
*.*.*.***.*.*..*******.*....*********.*
*.*.*.....*....*.....*.****..**.......*
*.*.**********.*.*.*.*.*.....*..*******
*................*.....*...*..........*
*.*************...............*********
*.*.*............**************.......*
*.*.***.***.*****....*..........*******
*.......*.......*.**..**.*.****.*.....*
*********.***...*...*....*....*...*****
*.........*...*****.*********..**.....*
***.*******......*..*....***.***..*****
*.*.......******.*.*...*.*.....*.*....*
*.*.*****.*....*...*.*.*...***.*.*.*.**
*.*.*.......****************.......*..*
*...*.*****.*..........**.......*******
*...*.....*.*.*********.....***.......*
*.******..*.*........*..************.**
*.*......**.********.**.*.*......*....*
***.*******...*......*..*...****.*.*.**
*...*.....*.***.*******....**....*.*.**
*.*...*.*...............****..**...*..*
***************************************
