***************************************
*.....................................*
*.*.*****************************.***.*
*...................................*.*
*.*.******.************************.*.*
*.*.*.............................*.*.*
*.*.*.***********************.***...*.*
*.*.*.*.........................*.*.*.*
*.*.*.*.*************.*********.*.*...*
*.*.*.*.*.....................*.*.*.*.*
*...*.*.*.*******************.*.*.*.*.*
*.*.*.*...*.................*.*.*.*.*.*
*.*.*.*.*.*.****.**********.*.*...*.*.*
*.*.*.*.*.*.*.............*.*.*.*.*.*.*
*.*.*.*.*.*.*.***********.*.*.*.*.*.*.*
*.*...*.*.*.*.*.........*.*...*.*.*.*.*
*.*.*.*.*.*.*.*.*.....*.*.*.*.*...*.*.*
*.*.*.*.*.*.*.*.*.***.*.*.*.*.*.*.*.*.*
*.*.*.*.*.*...*.........*.*.*.*.*.*.*.*
*...*.*.*.*.*.******.****.*.*.*.*.*.*.*
*.*.*.*.*.*.*.............*.*.*.*.*.*.*
*.*.*.*.*.*.********.******.*.*.*.*.*.*
*.*.*.*.*.*.................*.*.*...*.*
*.*.*...*.*****.*************.*.*.*.*.*
*.*.*.*.......................*.*.*.*.*
*.*.*.*.*.******************.**.*.*.*.*
*.*.*.*.........................*.*.*.*
*.*.*.************.**************.*.*.*
*.*.*...............................*.*
*.*.************************.******.*.*
*.*.................................*.*
*.****.***************************.**.*
*.....................................*
***************************************
